{
    "mapname": "御魂庆典",
    "grid": "13x13",
    "content": {
        "E1": "18",
        "F1": "19",
        "G1": "20",
        "H1": "21",
        "I1": "22",
        "E2": "17",
        "I2": "23",
        "C3": "14",
        "D3": "15",
        "E3": "16",
        "I3": "24",
        "J3": "25",
        "K3": "26",
        "C4": "13",
        "K4": "27",
        "A5": "10",
        "B5": "11",
        "C5": "12",
        "D5": "56",
        "E5": "55",
        "I5": "63",
        "J5": "64",
        "K5": "28",
        "L5": "29",
        "M5": "30",
        "A6": "9",
        "E6": "54",
        "I6": "62",
        "M6": "31",
        "A7": "8",
        "E7": "50",
        "F7": "49",
        "G7": "48",
        "H7": "57",
        "I7": "58",
        "M7": "32",
        "A8": "7",
        "E8": "51",
        "I8": "59",
        "M8": "33",
        "A9": "6",
        "B9": "5",
        "C9": "4",
        "D9": "53",
        "E9": "52",
        "I9": "60",
        "J9": "61",
        "K9": "36",
        "L9": "35",
        "M9": "34",
        "C10": "3",
        "K10": "37",
        "C11": "2",
        "K11": "38",
        "C12": "1",
        "F12": "45",
        "G12": "44",
        "H12": "43",
        "K12": "39",
        "C13": "0",
        "D13": "47",
        "E13": "46",
        "I13": "42",
        "J13": "41",
        "K13": "40"
    },
    "arrows": [
      {
        "color": "#fe1fee",
        "directions": [
          "C5->B5",
          "C9->C10",
          "E7->E8",
          "I7->H7",
          "K5->K4",
          "K9->L9"
        ]
      },
      {
        "color": "#00f1f9",
        "directions": [
          "C5->C4",
          "C9->B9",
          "E7->E6",
          "I7->I6",
          "K5->L5",
          "K9->K10"
        ]
      }
    ]
  }