{
    "mapname": "水乡古镇",
    "grid": "10x10",
    "content": {
        "A1": "33",
        "B1": "32",
        "C1": "31",
        "D1": "30",
        "G1": "27",
        "H1": "26",
        "I1": "25",
        "J1": "24",
        "A2": "34",
        "D2": "29",
        "G2": "28",
        "J2": "23",
        "A3": "35",
        "C3": "15",
        "D3": "14",
        "E3": "13",
        "F3": "12",
        "G3": "11",
        "H3": "10",
        "J3": "22",
        "A4": "36",
        "B4": "37",
        "C4": "16",
        "H4": "9",
        "I4": "20",
        "J4": "21",
        "C5": "17",
        "H5": "8",
        "C6": "18",
        "H6": "7",
        "A7": "54",
        "B7": "55",
        "C7": "19",
        "H7": "6",
        "I7": "38",
        "J7": "39",
        "A8": "53",
        "C8": "0",
        "D8": "1",
        "E8": "2",
        "F8": "3",
        "G8": "4",
        "H8": "5",
        "J8": "40",
        "A9": "52",
        "D9": "47",
        "G9": "46",
        "J9": "41",
        "A10": "51",
        "B10": "50",
        "C10": "49",
        "D10": "48",
        "G10": "45",
        "H10": "44",
        "I10": "43",
        "J10": "42"
    },
    "arrows": [
      {
        "color": "#fe1fee",
        "directions": [
          "C4->C3",
          "C7->C6",
          "D3->E3",
          "D8->C8",
          "G3->H3",
          "G8->F8",
          "H4->H5",
          "H7->H8"
        ]
      },
      {
        "color": "#00f1f9",
        "directions": [
          "C4->C5",
          "C7->C8",
          "D3->D2",
          "D8->E8",
          "G3->F3",
          "G8->H8",
          "H4->H3",
          "H7->H6"
        ]
      }
    ]
  }