{
  "mapname": "水乡古镇",
  "grid": "10x10",
  "content": {
      "A1": "51",
      "B1": "52",
      "C1": "53",
      "D1": "54",
      "G1": "36",
      "H1": "35",
      "J1": "33",
      "A2": "50",
      "D2": "55",
      "G2": "37",
      "J2": "32",
      "I1": "34",
      "A3": "49",
      "C3": "0",
      "D3": "19",
      "E3": "18",
      "F3": "17",
      "G3": "16",
      "H3": "15",
      "J3": "31",
      "A4": "48",
      "B4": "47",
      "C4": "1",
      "H4": "14",
      "I4": "29",
      "J4": "30",
      "C5": "2",
      "H5": "13",
      "C6": "3",
      "H6": "12",
      "A7": "45",
      "B7": "46",
      "C7": "4",
      "H7": "11",
      "I7": "28",
      "J7": "27",
      "A8": "44",
      "C8": "5",
      "D8": "6",
      "E8": "7",
      "F8": "8",
      "G8": "9",
      "H8": "10",
      "J8": "26",
      "A9": "43",
      "D9": "38",
      "G9": "20",
      "J9": "25",
      "A10": "42",
      "B10": "41",
      "C10": "40",
      "D10": "39",
      "G10": "21",
      "H10": "22",
      "I10": "23",
      "J10": "24"
  },
  "arrows": [
    {
      "color": "#fe1fee",
      "directions": [
        "C4->C3",
        "C7->C6",
        "D3->E3",
        "D8->C8",
        "G3->H3",
        "G8->F8",
        "H4->H5",
        "H7->H8"
      ]
    },
    {
      "color": "#00f1f9",
      "directions": [
        "C4->C5",
        "C7->C8",
        "D3->C3",
        "D8->E8",
        "G3->F3",
        "G8->H8",
        "H4->I4",
        "H7->H6"
      ]
    }
  ]
}